{
  "name": "Keychron Q0 Max ANSI Knob",
  "vendorProductId": 875825152,
  "macros": ["", "", "", "", "", "", "", "", "", "", "", "", "", "", "", ""],
  "layers": [
    [
      "KC_MUTE",
      "KC_ESC",
      "KC_DEL",
      "KC_TAB",
      "KC_BSPC",
      "KC_F24",
      "KC_NLCK",
      "KC_PSLS",
      "KC_PAST",
      "KC_PMNS",
      "KC_F23",
      "KC_P7",
      "KC_P8",
      "KC_P9",
      "KC_PPLS",
      "KC_F22",
      "KC_P4",
      "KC_P5",
      "KC_P6",
      "KC_NO",
      "MO(1)",
      "KC_P1",
      "KC_P2",
      "KC_P3",
      "KC_PENT",
      "MO(2)",
      "KC_P0",
      "KC_NO",
      "KC_PDOT",
      "KC_NO"
    ],
    [
      "RGB_TOG",
      "CUSTOM(11)",
      "CUSTOM(12)",
      "CUSTOM(13)",
      "CUSTOM(14)",
      "KC_TRNS",
      "RGB_MOD",
      "RGB_VAI",
      "RGB_HUI",
      "KC_TRNS",
      "KC_TRNS",
      "RGB_RMOD",
      "RGB_VAD",
      "RGB_HUD",
      "KC_TRNS",
      "KC_TRNS",
      "RGB_SAI",
      "RGB_SPI",
      "KC_MPRV",
      "KC_NO",
      "KC_TRNS",
      "RGB_SAD",
      "RGB_SPD",
      "KC_MPLY",
      "KC_TRNS",
      "KC_TRNS",
      "RGB_TOG",
      "KC_NO",
      "KC_MNXT",
      "KC_NO"
    ],
    [
      "KC_TRNS",
      "KC_TRNS",
      "KC_TRNS",
      "KC_TRNS",
      "KC_TRNS",
      "KC_TRNS",
      "KC_TRNS",
      "KC_TRNS",
      "KC_TRNS",
      "KC_TRNS",
      "KC_TRNS",
      "S(KC_9)",
      "KC_UP",
      "S(KC_0)",
      "KC_TRNS",
      "KC_TRNS",
      "KC_LEFT",
      "KC_DOWN",
      "KC_RGHT",
      "KC_NO",
      "KC_TRNS",
      "KC_TRNS",
      "KC_TRNS",
      "KC_TRNS",
      "KC_TRNS",
      "KC_TRNS",
      "KC_TRNS",
      "KC_NO",
      "KC_TRNS",
      "KC_NO"
    ],
    [
      "KC_TRNS",
      "KC_TRNS",
      "KC_TRNS",
      "KC_TRNS",
      "KC_TRNS",
      "KC_TRNS",
      "KC_TRNS",
      "KC_TRNS",
      "KC_TRNS",
      "KC_TRNS",
      "KC_TRNS",
      "KC_TRNS",
      "KC_TRNS",
      "KC_TRNS",
      "KC_TRNS",
      "KC_TRNS",
      "KC_TRNS",
      "KC_TRNS",
      "KC_TRNS",
      "KC_NO",
      "KC_TRNS",
      "KC_TRNS",
      "KC_TRNS",
      "KC_TRNS",
      "KC_TRNS",
      "KC_TRNS",
      "KC_TRNS",
      "KC_NO",
      "KC_TRNS",
      "KC_NO"
    ]
  ],
  "encoders": [
    [
      ["KC_VOLD", "KC_VOLU"],
      ["RGB_VAD", "RGB_VAI"],
      ["KC_VOLD", "KC_VOLU"],
      ["RGB_VAD", "RGB_VAI"]
    ]
  ]
}